SSSSSSSSSSSSSSSSSSSSSSSSSSSSSS
S                   SSS      S
S    WW             SS       S
S                            S
S                 GGGG       S
S      SS         GGGG       S
S      SS                    S
S                            S
S            SS              S
S                      WWWWW S
S   W                        S
S   W      GGG               S
S   W      GGG               S
S                            S
SSSSSSSSSSSSSSSSSSSSSSSSSSSSSS